Columns: 10
Rows: 10
0000000000
0100000000
0000000000
0001000000
0000000230
0000000450
0010000000
0100000000
0000010000
0000000000